Todd Gurley STL, 6	RB
Amari Cooper OAK, 6	WR
Melvin Gordon SD, 10	RB
Kevin White CHI, 7	WR
Devante Parker MIA, 5	WR
Nelson Agholor PHI, 8	WR
T.J. Yeldon JAC, 8	RB
Ameer Abdullah DET, 9	RB
Dorial Green-Beckham TEN, 4	WR
Breshad Perriman BAL, 9	WR
Tevin Coleman ATL, 10	RB
Duke Johnson CLE, 11	RB
Jameis Winston TB, 6	QB
Jaelen Strong HOU, 9	WR
Marcus Mariota TEN, 4	QB
Jay Ajayi MIA, 5	RB
Maxx Williams BAL, 9	TE
Devin Funchess CAR, 5	WR
Phillip Dorsett IND, 10	WR
David Cobb TEN, 4	RB
David Johnson ARI, 9	RB
Devin Smith NYJ, 5	WR
Tyler Lockett SEA, 9	WR
Javorius Allen BAL, 9	RB
Chris Conley KC, 9	WR
Sammie Coates PIT, 11	WR
Mike Davis SF, 10	RB
Josh Robinson IND, 10	RB
Justin Hardy ATL, 10	WR
Jeremy Langford CHI, 7	RB
DeAndre Smelter SF, 10	WR
Matt Jones WAS, 8	RB
Clive Walford OAK, 6	TE
Cameron Artis-Payne CAR, 5	RB
Tre McBride TEN, 4	WR
Kenny Bell TB, 6	WR
Stefon Diggs MIN, 5	WR
Rashad Greene JAC, 8	WR
Darren Waller BAL, 9	WR
Karlos Williams BUF, 8	RB
Ty Montgomery GB, 7	WR
Devante Davis PHI, 8	WR
Vince Mayle CLE, 11	WR
Bryce Petty NYJ, 5	QB
Brett Hundley GB, 7	QB
Zach Zenner DET, 9	RB
Garrett Grayson NO, 11	QB
Jamison Crowder WAS, 8	WR
Tyler Kroft CIN, 7	TE
Malcolm Brown STL, 6	RB
Jesse James PIT, 11	TE
Deontay Greenberry DAL, 6	WR
Michael Dyer OAK, 6	RB
DeAndre Carter BAL, 9	WR
Thomas Rawls SEA, 9	RB
Dezmin Lewis BUF, 8	WR
J.J. Nelson ARI, 9	WR
Blake Bell SF, 10	TE
Terrell Watson CIN, 7	RB
Austin Hill OAK, 6	WR
MyCole Pruitt MIN, 5	TE
Bud Sasser STL, 6	WR
Sean Mannion STL, 6	QB
Jeff Heuerman DEN, 7	TE